xxxxxxxxxxxxxxxxxxx
x==x============*=x
x=================x
x======x==========x
x=x===============x
x=================x
x=================x
x=================x
x=================x
x=================x
x=========x=======x
x=================x
xxxxxxxxxxxxxxxxxx