xxxxxxxxxxxxxxxxxxx
x==x==============x
x=================x
x======x==========x
x=x===============x
x===hhhhhhhhhhhhhhhh====x
x=====hhhhhhhhhhhh======x
x======hhhhhhhhhh======x
x=========hhhh====x
x=================x
x=========x=======x
x==*==============x
xxxxxxxxxxxxxxxxxx