xxxxxxxxxxxxxxxxxxx
x=================x
x==x=============x
x==x=======xxx==x
x=================x
x=================x
x=================x
x===xxxxx=====x
x=================x
x=================x
x===xxx=========xx==x
x=========*=======x
xxxxxxxxxxxxxxxxxx