xxxxxxxxxxxxxxxxxxx
x=====x===========x
x===x=============x
x======x==========x
x=x==========P====x
x=================x
x========x========x
x=====x===========x
x=================x
x=================x
x=*===x===x=======x
x=================x
xxxxxxxxxxxxxxxxxx