xxxxxxxxxxxxxxxxxxx
x=*===============x
x=================x
x==xxxxxxxxxxxx
x=================x
x==xxxx===========x
x=================x
x=================x
x=================x
x====ggggggggg======x
x=================x
x==x==============x
x=================x
x======x==========x
x=x===============x
x=================x
x==xxxxxxxxxx==x
x=================x
x=xxxxxxxxxxxxx========x
x=================x
x=========x=======x
x=================x
xxxxxxxxxxxxxxxxxx